W,W,W,W,W,W,W,W,W,W,W,W,W,
W, ,E, , , ,W, ,E, , , ,W,
W, , , , , ,W, , , , , ,W,
W, , , , , , , , , , , ,w,
W, , , , , ,W, , , , , ,W,
W, ,E, , , ,W, ,E, , , ,W,
W,W,W,W,W,W,W,W,W,W,W,W,W,
